##########################################################################################
#........................................................................................#
#........@...............................................................................#
#........................................................................................#
#........................................................................................#
#........................................................................................#
#........................................................................................#
#........................................................................................#
#........................................................................................#
#........................................................................................#
#########.........................................................########################
#.................................................................#......................#
#.................................................................#......................#
#.................................................................#......................#
#.................................................................###############........#
#........................................................................................#
#........................................................................................#
#........................................................................................#
#........................................................................................#
#........................................................................................#
#........................................................................................#
#........................................................................................#
#........................................................................................#
#........................................................................................#
#........................................................................................#
#........................................................................................#
#........................................................................................#
#........................................................................................#
#........................................................................................#
#........................................................................................#
#........................................................................................#
#........................................................................................#
#........................................................................................#
#........................................................................................#
##########################################################################################
